===========================
=......*.....=.....*......=
=.====.=====.=.=====.====.=
=.====.=====.*.=====.====.=
=...*........=........*...=
=.====.=*=========*=.====.=
=......=.....*.....=......=
=......=..*=====*..=......=
=..=.===..=.....=..===.=..=
=.=....=..=..*..=..=....=.=
=.=....=..=.....=..=....=.=
=..=.===..=.....=..===.=..=
=...*..=..*=====*..=..*...=
=......=.....*.....=......=
=.====.=.=========.=.====.=
=............=............=
=.====.=====.*.=====.====.=
=.====*=====.=.=====*====.=
=...........*=*...........=
===========================