=============
= ...*=.....=
=.===.=.===*=
=.===.=.===.=
=.....*.....=
=.=.=====.=.=
=*=...=...=.=
=.===.=.===.=
=.=......*=.=
=.=.==.==.=.=
=...=.*.=...=
=.=.=====.=.=
=.=.......=.=
=.=.=====.=.=
=.....=.....=
=.===...===.=
=.*.........=
=.=.=====.=.=
=.=...=...=.=
====..=..====
=.....*.....=
=============