====================
= .............*...=
======.========.====
=.*...........*....=
=.....============*=
=.........*........=
====================
