=======================
= ...................G=
=.===*===========.===.=
=.=*...............*=.=
=...=......=.....g=...=
=...=*.....=......=...=
=.===..=========..===.=
=...=.....g*.....*=...=
=...=..=========..=...=
=.=*...=...*...=...*=.=
=.=.=..=...=...=..=.=.=
=...=g.....=......=...=
=.======...=...======.=
=G...................G=
=======================
