====================
= .............*...=
====== ======== ====
=.*...........*....=
=.....==============
=.........*........=
====================
