=======================
= ....................=
=.===.===========.===.=
=.=*..           ..*=.=
=. .=      =      =. .=
=...=      =      =...=
=.===  =========  ===.=
=.  =.............=  .=
=.  =  =========  =  .=
=.=*   =       =   *=.=
=.= =  =   =   =  = =.=
=.  =      =      =  .=
=.======   =   ======.=
=.....................=
=======================
