====================
=         *        =
====== ======== ====
=           .      =
=    ===============
=        .         =
====================
