====================
= .............*..G=
======.========.====
=.*...........*....=
=.....============*=
=g........*........=
====================
