=======================
= ....................=
=.===*===========.===.=
=.=*...............*=.=
=...=......=......=...=
=...=*.....=......=...=
=.===..=========..===.=
=...=......*.....*=...=
=...=..=========..=...=
=.=*...=...*...=...*=.=
=.=.=..=...=...=..=.=.=
=...=......=......=...=
=.======...=...======.=
=.....................=
=======================
