=============
= ...*=....g=
=.===.=.===*=
=.===.=.===.=
=.....*.....=
=.=.=====.=.=
=*=...=...=.=
=.===.=.===.=
=.=...G..*=.=
=.=.==.==.=.=
=...=.*.=...=
=.=.=====.=.=
=.=.......=.=
=.=.=====.=.=
=.....=.....=
=.===.G.===.=
=.*.........=
=.=.=====.=.=
=.=...=...=.=
====..=..====
=g....*.....=
=============